# vim:set tabstop=38:
THROTTLE_FULL	Set throttles max
THROTTLE_INCR	Increment throttles
THROTTLE_INCR_SMALL	Increment throttles small
THROTTLE_DECR	Decrement throttles
THROTTLE_DECR_SMALL	Decrease throttles small
THROTTLE_CUT	Set throttles to idle
INCREASE_THROTTLE	Increment throttles
DECREASE_THROTTLE	Decrement throttles
THROTTLE_SET	Set throttles exactly (0- 16383)
AXIS_THROTTLE_SET	Set throttles (0- 16383)
THROTTLE1_SET	Set throttle 1 exactly (0 to 16383)
THROTTLE2_SET	Set throttle 2 exactly (0 to 16383)
THROTTLE3_SET	Set throttle 3 exactly (0 to 16383)
THROTTLE4_SET	Set throttle 4 exactly (0 to 16383)
THROTTLE1_FULL	Set throttle 1 max
THROTTLE1_INCR	Increment throttle 1
THROTTLE1_INCR_SMALL	Increment throttle 1 small
THROTTLE1_DECR	Decrement throttle 1
THROTTLE1_CUT	Set throttle 1 to idle
THROTTLE2_FULL	Set throttle 2 max
THROTTLE2_INCR	Increment throttle 2
THROTTLE2_INCR_SMALL	Increment throttle 2 small
THROTTLE2_DECR	Decrement throttle 2
THROTTLE2_CUT	Set throttle 2 to idle
THROTTLE3_FULL	Set throttle 3 max
THROTTLE3_INCR	Increment throttle 3
THROTTLE3_INCR_SMALL	Increment throttle 3 small
THROTTLE3_DECR	Decrement throttle 3
THROTTLE3_CUT	Set throttle 3 to idle
THROTTLE4_FULL	Set throttle 1 max
THROTTLE4_INCR	Increment throttle 4
THROTTLE4_INCR_SMALL	Increment throttle 4 small
THROTTLE4_DECR	Decrement throttle 4
THROTTLE4_CUT	Set throttle 4 to idle
THROTTLE_10	Set throttles to 10%
THROTTLE_20	Set throttles to 20%
THROTTLE_30	Set throttles to 30%
THROTTLE_40	Set throttles to 40%
THROTTLE_50	Set throttles to 50%
THROTTLE_60	Set throttles to 60%
THROTTLE_70	Set throttles to 70%
THROTTLE_80	Set throttles to 80%
THROTTLE_90	Set throttles to 90%
AXIS_THROTTLE1_SET	Set throttle 1 exactly (-16383 - +16383)
AXIS_THROTTLE2_SET	Set throttle 2 exactly (-16383 - +16383)
AXIS_THROTTLE3_SET	Set throttle 3 exactly (-16383 - +16383)
AXIS_THROTTLE4_SET	Set throttle 4 exactly (-16383 - +16383)
THROTTLE1_DECR_SMALL	Decrease throttle 1 small
THROTTLE2_DECR_SMALL	Decrease throttle 2 small
THROTTLE3_DECR_SMALL	Decrease throttle 3 small
THROTTLE4_DECR_SMALL	Decrease throttle 4 small
PROP_PITCH_DECR_SMALL	Decrease prop levers small
PROP_PITCH1_DECR_SMALL	Decrease prop lever 1 small
PROP_PITCH2_DECR_SMALL	Decrease prop lever 2 small
PROP_PITCH3_DECR_SMALL	Decrease prop lever 3 small
PROP_PITCH4_DECR_SMALL	Decrease prop lever 4 small
MIXTURE1_RICH	Set mixture lever 1 to max rich
MIXTURE1_INCR	Increment mixture lever 1
MIXTURE1_INCR_SMALL	Increment mixture lever 1 small
MIXTURE1_DECR	Decrement mixture lever 1
MIXTURE1_LEAN	Set mixture lever 1 to max lean
MIXTURE2_RICH	Set mixture lever 2 to max rich
MIXTURE2_INCR	Increment mixture lever 2
MIXTURE2_INCR_SMALL	Increment mixture lever 2 small
MIXTURE2_DECR	Decrement mixture lever 2
MIXTURE2_LEAN	Set mixture lever 2 to max lean
MIXTURE3_RICH	Set mixture lever 3 to max rich
MIXTURE3_INCR	Increment mixture lever 3
MIXTURE3_INCR_SMALL	Increment mixture lever 3 small
MIXTURE3_DECR	Decrement mixture lever 3
MIXTURE3_LEAN	Set mixture lever 3 to max lean
MIXTURE4_RICH	Set mixture lever 4 to max rich
MIXTURE4_INCR	Increment mixture lever 4
MIXTURE4_INCR_SMALL	Increment mixture lever 4 small
MIXTURE4_DECR	Decrement mixture lever 4
MIXTURE4_LEAN	Set mixture lever 4 to max lean
MIXTURE_SET	Set mixture levers to exact value (0 to 16383)
MIXTURE_RICH	Set mixture levers to max rich
MIXTURE_INCR	Increment mixture levers
MIXTURE_INCR_SMALL	Increment mixture levers small
MIXTURE_DECR	Decrement mixture levers
MIXTURE_LEAN	Set mixture levers to max lean
MIXTURE1_SET	Set mixture lever 1 exact value (0 to 16383)
MIXTURE2_SET	Set mixture lever 2 exact value (0 to 16383)
MIXTURE3_SET	Set mixture lever 3 exact value (0 to 16383)
MIXTURE4_SET	Set mixture lever 4 exact value (0 to 16383)
AXIS_MIXTURE_SET	Set mixture lever 1 exact value (-16383 to +16383)
AXIS_MIXTURE1_SET	Set mixture lever 1 exact value (-16383 to +16383)
AXIS_MIXTURE2_SET	Set mixture lever 2 exact value (-16383 to +16383)
AXIS_MIXTURE3_SET	Set mixture lever 3 exact value (-16383 to +16383)
AXIS_MIXTURE4_SET	Set mixture lever 4 exact value (-16383 to +16383)
MIXTURE_SET_BEST	Set mixture levers to current best power setting
MIXTURE_DECR_SMALL	Decrement mixture levers small
MIXTURE1_DECR_SMALL	Decrement mixture lever 1 small
MIXTURE2_DECR_SMALL	Decrement mixture lever 4 small
MIXTURE3_DECR_SMALL	Decrement mixture lever 4 small
MIXTURE4_DECR_SMALL	Decrement mixture lever 4 small
PROP_PITCH_SET	Set prop pitch levers (0 to 16383)
PROP_PITCH_LO	Set prop pitch levers max (lo pitch)
PROP_PITCH_INCR	Increment prop pitch levers
PROP_PITCH_INCR_SMALL	Increment prop pitch levers small
PROP_PITCH_DECR	Decrement prop pitch levers
PROP_PITCH_HI	Set prop pitch levers min (hi pitch)
PROP_PITCH1_SET	Set prop pitch lever 1 exact value (0 to 16383)
PROP_PITCH2_SET	Set prop pitch lever 2 exact value (0 to 16383)
PROP_PITCH3_SET	Set prop pitch lever 3 exact value (0 to 16383)
PROP_PITCH4_SET	Set prop pitch lever 4 exact value (0 to 16383)
PROP_PITCH1_LO	Set prop pitch lever 1 max (lo pitch)
PROP_PITCH1_INCR	Increment prop pitch lever 1
PROP_PITCH1_INCR_SMALL	Increment prop pitch lever 1 small
PROP_PITCH1_DECR	Decrement prop pitch lever 1
PROP_PITCH1_HI	Set prop pitch lever 1 min (hi pitch)
PROP_PITCH2_LO	Set prop pitch lever 2 max (lo pitch)
PROP_PITCH2_INCR	Increment prop pitch lever 2
PROP_PITCH2_INCR_SMALL	Increment prop pitch lever 2 small
PROP_PITCH2_DECR	Decrement prop pitch lever 2
PROP_PITCH2_HI	Set prop pitch lever 2 min (hi pitch)
PROP_PITCH3_LO	Set prop pitch lever 3 max (lo pitch)
PROP_PITCH3_INCR	Increment prop pitch lever 3
PROP_PITCH3_INCR_SMALL	Increment prop pitch lever 3 small
PROP_PITCH3_DECR	Decrement prop pitch lever 3
PROP_PITCH3_HI	Set prop pitch lever 3 min (hi pitch)
PROP_PITCH4_LO	Set prop pitch lever 4 max (lo pitch)
PROP_PITCH4_INCR	Increment prop pitch lever 4
PROP_PITCH4_INCR_SMALL	Increment prop pitch lever 4 small
PROP_PITCH4_DECR	Decrement prop pitch lever 4
PROP_PITCH4_HI	Set prop pitch lever 4 min (hi pitch)
AXIS_PROPELLER_SET	Set propeller levers exact value (-16383 to +16383)
AXIS_PROPELLER1_SET	Set propeller lever 1 exact value (-16383 to +16383)
AXIS_PROPELLER2_SET	Set propeller lever 2 exact value (-16383 to +16383)
AXIS_PROPELLER3_SET	Set propeller lever 3 exact value (-16383 to +16383)
AXIS_PROPELLER4_SET	Set propeller lever 4 exact value (-16383 to +16383)
JET_STARTER	Selects jet engine starter (for +/- sequence)
MAGNETO_SET	Sets magnetos (0,1)
TOGGLE_STARTER1	Toggle starter 1
TOGGLE_STARTER2	Toggle starter 2
TOGGLE_STARTER3	Toggle starter 3
TOGGLE_STARTER4	Toggle starter 4
TOGGLE_ALL_STARTERS	Toggle starters
ENGINE_AUTO_START	Triggers auto-start
ENGINE_AUTO_SHUTDOWN	Triggers auto-shutdown
MAGNETO	Selects magnetos (for +/- sequence)
MAGNETO_DECR	Decrease magneto switches positions
MAGNETO_INCR	Increase magneto switches positions
MAGNETO1_OFF	Set engine 1 magnetos off
MAGNETO1_RIGHT	Toggle engine 1 right magneto
MAGNETO1_LEFT	Toggle engine 1 left magneto
MAGNETO1_BOTH	Set engine 1 magnetos on
MAGNETO1_START	Set engine 1 magnetos on and toggle starter
MAGNETO2_OFF	Set engine 2 magnetos off
MAGNETO2_RIGHT	Toggle engine 2 right magneto
MAGNETO2_LEFT	Toggle engine 2 left magneto
MAGNETO2_BOTH	Set engine 2 magnetos on
MAGNETO2_START	Set engine 2 magnetos on and toggle starter
MAGNETO3_OFF	Set engine 3 magnetos off
MAGNETO3_RIGHT	Toggle engine 3 right magneto
MAGNETO3_LEFT	Toggle engine 3 left magneto
MAGNETO3_BOTH	Set engine 3 magnetos on
MAGNETO3_START	Set engine 3 magnetos on and toggle starter
MAGNETO4_OFF	Set engine 4 magnetos off
MAGNETO4_RIGHT	Toggle engine 4 right magneto
MAGNETO4_LEFT	Toggle engine 4 left magneto
MAGNETO4_BOTH	Set engine 4 magnetos on
MAGNETO4_START	Set engine 4 magnetos on and toggle starter
MAGNETO_OFF	Set engine magnetos off
MAGNETO_RIGHT	Set engine right magnetos on
MAGNETO_LEFT	Set engine left magnetos on
MAGNETO_BOTH	Set engine magnetos on
MAGNETO_START	Set engine magnetos on and toggle starters
MAGNETO1_DECR	Decrease engine 1 magneto switch position
MAGNETO1_INCR	Increase engine 1 magneto switch position
MAGNETO2_DECR	Decrease engine 2 magneto switch position
MAGNETO2_INCR	Increase engine 2 magneto switch position
MAGNETO3_DECR	Decrease engine 3 magneto switch position
MAGNETO3_INCR	Increase engine 3 magneto switch position
MAGNETO4_DECR	Decrease engine 4 magneto switch position
MAGNETO4_INCR	Increase engine 4 magneto switch position
Not supported	Set engine magneto switches
MAGNETO1_SET	Set engine 1 magneto switch
MAGNETO2_SET	Set engine 2 magneto switch
MAGNETO3_SET	Set engine 3 magneto switch
MAGNETO4_SET	Set engine 4 magneto switch
ANTI_ICE_ON	Sets anti-ice switches on
ANTI_ICE_OFF	Sets anti-ice switches off
ANTI_ICE_SET	Sets anti-ice switches from argument (0,1)
ANTI_ICE_TOGGLE	Toggle anti-ice switches
ANTI_ICE_TOGGLE_ENG1	Toggle engine 1 anti-ice switch
ANTI_ICE_TOGGLE_ENG2	Toggle engine 2 anti-ice switch
ANTI_ICE_TOGGLE_ENG3	Toggle engine 3 anti-ice switch
ANTI_ICE_TOGGLE_ENG4	Toggle engine 4 anti-ice switch
ANTI_ICE_SET_ENG1	Sets engine 1 anti-ice switch (0,1)
ANTI_ICE_SET_ENG2	Sets engine 2 anti-ice switch (0,1)
ANTI_ICE_SET_ENG3	Sets engine 3 anti-ice switch (0,1)
ANTI_ICE_SET_ENG4	Sets engine 4 anti-ice switch (0,1)
TOGGLE_FUEL_VALVE_ALL	Toggle engine fuel valves
TOGGLE_FUEL_VALVE_ENG1	Toggle engine 1 fuel valve
TOGGLE_FUEL_VALVE_ENG2	Toggle engine 2 fuel valve
TOGGLE_FUEL_VALVE_ENG3	Toggle engine 3 fuel valve
TOGGLE_FUEL_VALVE_ENG4	Toggle engine 4 fuel valve
COWLFLAP1_SET	Sets engine 1 cowl flap lever position (0 to 16383)
COWLFLAP2_SET	Sets engine 2 cowl flap lever position (0 to 16383)
COWLFLAP3_SET	Sets engine 3 cowl flap lever position (0 to 16383)
COWLFLAP4_SET	Sets engine 4 cowl flap lever position (0 to 16383)
INC_COWL_FLAPS	Increment cowl flap levers
DEC_COWL_FLAPS	Decrement cowl flap levers
INC_COWL_FLAPS1	Increment engine 1 cowl flap lever
DEC_COWL_FLAPS1	Decrement engine 1 cowl flap lever
INC_COWL_FLAPS2	Increment engine 2 cowl flap lever
DEC_COWL_FLAPS2	Decrement engine 2 cowl flap lever
INC_COWL_FLAPS3	Increment engine 3 cowl flap lever
DEC_COWL_FLAPS3	Decrement engine 3 cowl flap lever
INC_COWL_FLAPS4	Increment engine 4 cowl flap lever
DEC_COWL_FLAPS4	Decrement engine 4 cowl flap lever
FUEL_PUMP	Toggle electric fuel pumps
TOGGLE_ELECT_FUEL_PUMP	Toggle electric fuel pumps
TOGGLE_ELECT_FUEL_PUMP1	Toggle engine 1 electric fuel pump
TOGGLE_ELECT_FUEL_PUMP2	Toggle engine 2 electric fuel pump
TOGGLE_ELECT_FUEL_PUMP3	Toggle engine 3 electric fuel pump
TOGGLE_ELECT_FUEL_PUMP4	Toggle engine 4 electric fuel pump
ENGINE_PRIMER	Trigger engine primers
TOGGLE_PRIMER	Trigger engine primers
TOGGLE_PRIMER1	Trigger engine 1 primer
TOGGLE_PRIMER2	Trigger engine 2 primer
TOGGLE_PRIMER3	Trigger engine 3 primer
TOGGLE_PRIMER4	Trigger engine 4 primer
TOGGLE_FEATHER_SWITCHES	Trigger propeller switches
TOGGLE_FEATHER_SWITCH_1	Trigger propeller 1 switch
TOGGLE_FEATHER_SWITCH_2	Trigger propeller 2 switch
TOGGLE_FEATHER_SWITCH_3	Trigger propeller 3 switch
TOGGLE_FEATHER_SWITCH_4	Trigger propeller 4 switch
TOGGLE_PROPELLER_SYNC	Turns propeller synchronization switch on
TOGGLE_AUTOFEATHER_ARM	Turns auto-feather arming switch on.
TOGGLE_AFTERBURNER	Toggles afterburners
TOGGLE_AFTERBURNER1	Toggles engine 1 afterburner
TOGGLE_AFTERBURNER2	Toggles engine 2 afterburner
TOGGLE_AFTERBURNER3	Toggles engine 3 afterburner
TOGGLE_AFTERBURNER4	Toggles engine 4 afterburner
ENGINE	Sets engines for 1,2,3,4 selection (to be followed by SELECT_n)


SPOILERS_TOGGLE	Toggles spoiler handle
FLAPS_UP	Sets flap handle to full retract position
FLAPS_1	Sets flap handle to first extension position
FLAPS_2	Sets flap handle to second extension position
FLAPS_3	Sets flap handle to third extension position
FLAPS_DOWN	Sets flap handle to full extension position
ELEV_TRIM_DN	Increments elevator trim down
ELEV_DOWN	Increments elevator down
AILERONS_LEFT	Increments ailerons left
CENTER_AILER_RUDDER	Centers aileron and rudder positions
AILERONS_RIGHT	Increments ailerons right
ELEV_TRIM_UP	Increment elevator trim up
ELEV_UP	Increments elevator up
RUDDER_LEFT	Increments rudder left
RUDDER_CENTER	Centers rudder position
RUDDER_RIGHT	Increments rudder right
ELEVATOR_SET	Sets elevator position (-16383 - +16383)
AILERON_SET	Sets aileron position (-16383 - +16383)
RUDDER_SET	Sets rudder position (-16383 - +16383)
FLAPS_INCR	Increments flap handle position
FLAPS_DECR	Decrements flap handle position
AXIS_ELEVATOR_SET	Sets elevator position (-16383 - +16383)
AXIS_AILERONS_SET	Sets aileron position (-16383 - +16383)
AXIS_RUDDER_SET	Sets rudder position (-16383 - +16383)
AXIS_ELEV_TRIM_SET	Sets elevator trim position (-16383 - +16383)
SPOILERS_SET	Sets spoiler handle position (0 to 16383)
SPOILERS_ARM_TOGGLE	Toggles arming of auto-spoilers
SPOILERS_ON	Sets spoiler handle to full extend position
SPOILERS_OFF	Sets spoiler handle to full retract position
SPOILERS_ARM_ON	Sets auto-spoiler arming on
SPOILERS_ARM_OFF	Sets auto-spoiler arming off
SPOILERS_ARM_SET	Sets auto-spoiler arming (0,1)
AILERON_TRIM_LEFT	Increments aileron trim left
AILERON_TRIM_RIGHT	Increments aileron trim right
RUDDER_TRIM_LEFT	Increments rudder trim left
RUDDER_TRIM_RIGHT	Increments aileron trim right
AXIS_SPOILER_SET	Sets spoiler handle position (-16383 - +16383)
FLAPS_SET	Sets flap handle to closest increment (0 to 16383)
ELEVATOR_TRIM_SET	Sets elevator trim position (0 to 16383)
AXIS_FLAPS_SET	Sets flap handle to closest increment (-16383 - +16383)

AP_MASTER	Toggles AP on/off
AUTOPILOT_OFF	Turns AP off
AUTOPILOT_ON	Turns AP on
YAW_DAMPER_TOGGLE	Toggles yaw damper on/off
AP_PANEL_HEADING_HOLD	Toggles heading hold mode on/off
AP_PANEL_ALTITUDE_HOLD	Toggles altitude hold mode on/off
AP_ATT_HOLD_ON	Turns on AP wing leveler and pitch hold mode
AP_LOC_HOLD_ON	Turns AP localizer hold on/armed and glide-slope hold mode off
AP_APR_HOLD_ON	Turns both AP localizer and glide-slope modes on/armed
AP_HDG_HOLD_ON	Turns heading hold mode on
AP_ALT_HOLD_ON	Turns altitude hold mode on
AP_WING_LEVELER_ON	Turns wing leveler mode on
AP_BC_HOLD_ON	Turns localizer back course hold mode on/armed
AP_NAV1_HOLD_ON	Turns lateral hold mode on
AP_ATT_HOLD_OFF	Turns off attitude hold mode
AP_LOC_HOLD_OFF	Turns off localizer hold mode
AP_APR_HOLD_OFF	Turns off approach hold mode
AP_HDG_HOLD_OFF	Turns off heading hold mode
AP_ALT_HOLD_OFF	Turns off altitude hold mode
AP_WING_LEVELER_OFF	Turns off wing leveler mode
AP_BC_HOLD_OFF	Turns off backcourse mode for localizer hold
AP_NAV1_HOLD_OFF	Turns off nav hold mode
AP_AIRSPEED_HOLD	Toggles airspeed hold mode
AUTO_THROTTLE_ARM	Toggles autothrottle arming mode
AUTO_THROTTLE_TO_GA	Toggles Takeoff/Go Around mode
HEADING_BUG_INC	Increments heading hold reference bug
HEADING_BUG_DEC	Decrements heading hold reference bug
HEADING_BUG_SET	Set heading hold reference bug (degrees)
AP_PANEL_SPEED_HOLD	Toggles airspeed hold mode
AP_ALT_VAR_INC	Increments reference altitude
AP_ALT_VAR_DEC	Decrements reference altitude
AP_VS_VAR_INC	Increments vertical speed reference
AP_VS_VAR_DEC	Decrements vertical speed reference
AP_SPD_VAR_INC	Increments airspeed hold reference
AP_SPD_VAR_DEC	Decrements airspeed hold reference
AP_PANEL_MACH_HOLD	Toggles mach hold
AP_MACH_VAR_INC	Increments reference mach
AP_MACH_VAR_DEC	Decrements reference mach
AP_MACH_HOLD	Toggles mach hold
AP_ALT_VAR_SET_METRIC	Sets reference altitude in meters
AP_VS_VAR_SET_ENGLISH	Sets reference vertical speed in feet per minute
AP_SPD_VAR_SET	Sets airspeed reference in knots
AP_MACH_VAR_SET	Sets mach reference
YAW_DAMPER_ON	Turns yaw damper on
YAW_DAMPER_OFF	Turns yaw damper off
YAW_DAMPER_SET	Sets yaw damper on/off (1,0)
AP_AIRSPEED_ON	Turns airspeed hold on
AP_AIRSPEED_OFF	Turns airspeed hold off
AP_AIRSPEED_SET	Sets airspeed hold on/off (1,0)
AP_MACH_ON	Turns mach hold on
AP_MACH_OFF	Turns mach hold off
AP_MACH_SET	Sets mach hold on/off (1,0)
AP_PANEL_ALTITUDE_ON	Turns altitude hold mode on (without capturing current altitude)
AP_PANEL_ALTITUDE_OFF	Turns altitude hold mode off
AP_PANEL_ALTITUDE_SET	Sets altitude hold mode on/off (1,0)
AP_PANEL_HEADING_ON	Turns heading mode on (without capturing current heading)
AP_PANEL_HEADING_OFF	Turns heading mode off
AP_PANEL_HEADING_SET	Set heading mode on/off (1,0)
AP_PANEL_MACH_ON	Turns on mach hold
AP_PANEL_MACH_OFF	Turns off mach hold
AP_PANEL_MACH_SET	Sets mach hold on/off (1,0)
AP_PANEL_SPEED_ON	Turns on speed hold mode
AP_PANEL_SPEED_OFF	Turns off speed hold mode
AP_PANEL_SPEED_SET	Set speed hold mode on/off (1,0)
AP_ALT_VAR_SET_ENGLISH	Sets altitude reference in feet
AP_VS_VAR_SET_METRIC	Sets vertical speed reference in meters per minute
TOGGLE_FLIGHT_DIRECTOR	Toggles flight director on/off
SYNC_FLIGHT_DIRECTOR_PITCH	Synchronizes flight director pitch with current aircraft pitch
INCREASE_AUTOBRAKE_CONTROL	Increments autobrake level
DECREASE_AUTOBRAKE_CONTROL	Decrements autobrake level
AP_PANEL_SPEED_HOLD_TOGGLE	Turns airspeed hold mode on with current airspeed
AP_PANEL_MACH_HOLD_TOGGLE	Sets mach hold reference to current mach
AP_NAV_SELECT_SET	Sets the nav (1 or 2) which is used by the Nav hold modes
HEADING_BUG_SELECT	Selects the heading bug for use with +/-
ALTITUDE_BUG_SELECT	Selects the altitude reference for use with +/-
VSI_BUG_SELECT	Selects the vertical speed reference for use with +/-
AIRSPEED_BUG_SELECT	Selects the airspeed reference for use with +/-
AP_PITCH_REF_INC_UP	Increments the pitch reference for pitch hold mode
AP_PITCH_REF_INC_DN	Decrements the pitch reference for pitch hold mode
AP_PITCH_REF_SELECT	Selects pitch reference for use with +/-
AP_ATT_HOLD	Toggle attitude hold mode
AP_LOC_HOLD	Toggles localizer (only) hold mode
AP_APR_HOLD	Toggles approach hold (localizer and glide-slope)
AP_HDG_HOLD	Toggles heading hold mode
AP_ALT_HOLD	Toggles altitude hold mode
AP_WING_LEVELER	Toggles wing leveler mode
AP_BC_HOLD	Toggles the backcourse mode for the localizer hold
AP_NAV1_HOLD	Toggles the nav hold mode
AP_MAX_BANK_INC	Autopilot max bank angle increment.
AP_MAX_BANK_DEC	Autopilot max bank angle decrement.
AP_N1_HOLD	Autopilot, hold the N1 percentage at its current level.
AP_N1_REF_INC	Increment the autopilot N1 reference.
AP_N1_REF_DEC	Decrement the autopilot N1 reference.
AP_N1_REF_SET	Sets the autopilot N1 reference.
FLY_BY_WIRE_ELAC_TOGGLE	Turn on or off the fly by wire Elevators and Ailerons computer.
FLY_BY_WIRE_FAC_TOGGLE	Turn on or off the fly by wire Flight Augmentation computer.
FLY_BY_WIRE_SEC_TOGGLE	Turn on or off the fly by wire Spoilers and Elevators computer.



G1000_PFD_FLIGHTPLAN_BUTTON	The primary flight display (PFD) should display its current flight plan.
G1000_PFD_PROCEDURE_BUTTON	Turn to the Procedure page.
G1000_PFD_ZOOMIN_BUTTON	Zoom in on the current map.
G1000_PFD_ZOOMOUT_BUTTON	Zoom out on the current map.
G1000_PFD_DIRECTTO_BUTTON	Turn to the Direct To page.
G1000_PFD_MENU_BUTTON	If a segmented flight plan is highlighted, activates the associated menu.
G1000_PFD_CLEAR_BUTTON	Clears the current input.
G1000_PFD_ENTER_BUTTON	Enters the current input.
G1000_PFD_CURSOR_BUTTON	Turns on or off a screen cursor.
G1000_PFD_GROUP_KNOB_INC	Step up through the page groups.
G1000_PFD_GROUP_KNOB_DEC	Step down through the page groups.
G1000_PFD_PAGE_KNOB_INC	Step up through the individual pages.
G1000_PFD_PAGE_KNOB_DEC	Step down through the individual pages.
G1000_PFD_SOFTKEY1	G1000 Softkey 1
G1000_PFD_SOFTKEY2	G1000 Softkey 2
G1000_PFD_SOFTKEY3	G1000 Softkey 3
G1000_PFD_SOFTKEY4	G1000 Softkey 4
G1000_PFD_SOFTKEY5	G1000 Softkey 5
G1000_PFD_SOFTKEY6	G1000 Softkey 6
G1000_PFD_SOFTKEY7	G1000 Softkey 7
G1000_PFD_SOFTKEY8	G1000 Softkey 8
G1000_PFD_SOFTKEY9	G1000 Softkey 9
G1000_PFD_SOFTKEY10	G1000 Softkey 10
G1000_PFD_SOFTKEY11	G1000 Softkey 11
G1000_PFD_SOFTKEY12	G1000 Softkey 12


G1000_MFD_FLIGHTPLAN_BUTTON	The multifunction display (MFD) should display its current flight plan.
G1000_MFD_PROCEDURE_BUTTON	Turn to the Procedure page.
G1000_MFD_ZOOMIN_BUTTON	Zoom in on the current map.
G1000_MFD_ZOOMOUT_BUTTON	Zoom out on the current map.
G1000_MFD_DIRECTTO_BUTTON	Turn to the Direct To page.
G1000_MFD_MENU_BUTTON	If a segmented flight plan is highlighted, activates the associated menu.
G1000_MFD_CLEAR_BUTTON	Clears the current input.
G1000_MFD_ENTER_BUTTON	Enters the current input.
G1000_MFD_CURSOR_BUTTON	Turns on or off a screen cursor.
G1000_MFD_GROUP_KNOB_INC	Step up through the page groups.
G1000_MFD_GROUP_KNOB_DEC	Step down through the page groups.
G1000_MFD_PAGE_KNOB_INC	Step up through the individual pages.
G1000_MFD_PAGE_KNOB_DEC	Step down through the individual pages.
G1000_MFD_SOFTKEY1	G1000 Softkey 1
G1000_MFD_SOFTKEY2	G1000 Softkey 2
G1000_MFD_SOFTKEY3	G1000 Softkey 3
G1000_MFD_SOFTKEY4	G1000 Softkey 4
G1000_MFD_SOFTKEY5	G1000 Softkey 5
G1000_MFD_SOFTKEY6	G1000 Softkey 6
G1000_MFD_SOFTKEY7	G1000 Softkey 7
G1000_MFD_SOFTKEY8	G1000 Softkey 8
G1000_MFD_SOFTKEY9	G1000 Softkey 9
G1000_MFD_SOFTKEY10	G1000 Softkey 10
G1000_MFD_SOFTKEY11	G1000 Softkey 11
G1000_MFD_SOFTKEY12	G1000 Softkey 12



FUEL_SELECTOR_OFF	Turns selector 1 to OFF position
FUEL_SELECTOR_ALL	Turns selector 1 to ALL position
FUEL_SELECTOR_LEFT	Turns selector 1 to LEFT position (burns from tip then aux then main)
FUEL_SELECTOR_RIGHT	Turns selector 1 to RIGHT position (burns from tip then aux then main)
FUEL_SELECTOR_LEFT_AUX	Turns selector 1 to LEFT AUX position
FUEL_SELECTOR_RIGHT_AUX	Turns selector 1 to RIGHT AUX position
FUEL_SELECTOR_CENTER	Turns selector 1 to CENTER position
FUEL_SELECTOR_SET	Sets selector 1 position (see code list below)
FUEL_SELECTOR_2_OFF	Turns selector 2 to OFF position
FUEL_SELECTOR_2_ALL	Turns selector 2 to ALL position
FUEL_SELECTOR_2_LEFT	Turns selector 2 to LEFT position (burns from tip then aux then main)
FUEL_SELECTOR_2_RIGHT	Turns selector 2 to RIGHT position (burns from tip then aux then main)
FUEL_SELECTOR_2_LEFT_AUX	Turns selector 2 to LEFT AUX position
FUEL_SELECTOR_2_RIGHT_AUX	Turns selector 2 to RIGHT AUX position
FUEL_SELECTOR_2_CENTER	Turns selector 2 to CENTER position
FUEL_SELECTOR_2_SET	Sets selector 2 position (see code list below)
FUEL_SELECTOR_3_OFF	Turns selector 3 to OFF position
FUEL_SELECTOR_3_ALL	Turns selector 3 to ALL position
FUEL_SELECTOR_3_LEFT	Turns selector 3 to LEFT position (burns from tip then aux then main)
FUEL_SELECTOR_3_RIGHT	Turns selector 3 to RIGHT position (burns from tip then aux then main)
FUEL_SELECTOR_3_LEFT_AUX	Turns selector 3 to LEFT AUX position
FUEL_SELECTOR_3_RIGHT_AUX	Turns selector 3 to RIGHT AUX position
FUEL_SELECTOR_3_CENTER	Turns selector 3 to CENTER position
FUEL_SELECTOR_3_SET	Sets selector 3 position (see code list below)
FUEL_SELECTOR_4_OFF	Turns selector 4 to OFF position
FUEL_SELECTOR_4_ALL	Turns selector 4 to ALL position
FUEL_SELECTOR_4_LEFT	Turns selector 4 to LEFT position (burns from tip then aux then main)
FUEL_SELECTOR_4_RIGHT	Turns selector 4 to RIGHT position (burns from tip then aux then main)
FUEL_SELECTOR_4_LEFT_AUX	Turns selector 4 to LEFT AUX position
FUEL_SELECTOR_4_RIGHT_AUX	Turns selector 4 to RIGHT AUX position
FUEL_SELECTOR_4_CENTER	Turns selector 4 to CENTER position
FUEL_SELECTOR_4_SET	Sets selector 4 position (see code list below)
CROSS_FEED_OPEN	Opens cross feed valve (when used in conjunction with "isolate" tank)
CROSS_FEED_TOGGLE	Toggles crossfeed valve (when used in conjunction with "isolate" tank)
CROSS_FEED_OFF	Closes crossfeed valve (when used in conjunction with "isolate" tank)
FUEL_DUMP_SWITCH_SET	Set to True or False. The switch can only be set to True if fuel_dump_rate is specified in the aircraft configuration file, which indicates that a fuel dump system exists.
ANTIDETONATION_TANK_VALVE_TOGGLE	Toggle the antidetonation valve. Pass a value to determine which tank, if there are multiple tanks, to use. Tanks are indexed from 1. Refer to the document Notes on Aircraft Systems.
NITROUS_TANK_VALVE_TOGGLE	Toggle the nitrous valve. Pass a value to determine which tank, if there are multiple tanks, to use. Tanks are indexed from 1.
REPAIR_AND_REFUEL	Fully repair and refuel the user aircraft. Ignored if flight realism is enforced.
FUEL_DUMP_TOGGLE	Turns on or off the fuel dump switch.
REQUEST_FUEL_KEY	Request a fuel truck. The aircraft must be in a parking spot for this to be successful.

FUEL_SELECTOR_LEFT_MAIN	Sets the fuel selector. Fuel will be taken in the order left tip, left aux, then main fuel tanks.
FUEL_SELECTOR_2_LEFT_MAIN	Sets the fuel selector for engine 2.
FUEL_SELECTOR_3_LEFT_MAIN	Sets the fuel selector for engine 3.
FUEL_SELECTOR_4_LEFT_MAIN	Sets the fuel selector for engine 4.
FUEL_SELECTOR_RIGHT_MAIN	Sets the fuel selector. Fuel will be taken in the order right tip, right aux, then main fuel tanks.
FUEL_SELECTOR_2_RIGHT_MAIN	Sets the fuel selector for engine 2.
FUEL_SELECTOR_3_RIGHT_MAIN	Sets the fuel selector for engine 3.
FUEL_SELECTOR_4_RIGHT_MAIN	Sets the fuel selector for engine 4.

XPNDR	Sequentially selects the transponder digits for use with +/-.
ADF	Sequentially selects the ADF tuner digits for use with +/-. Follow by KEY_SELECT_2 for ADF 2.
DME	Selects the DME for use with +/-
COM_RADIO	Sequentially selects the COM tuner digits for use with +/-. Follow by KEY_SELECT_2 for COM 2.
VOR_OBS	Sequentially selects the VOR OBS for use with +/-. Follow by KEY_SELECT_2 for VOR 2.
NAV_RADIO	Sequentially selects the NAV tuner digits for use with +/-. Follow by KEY_SELECT_2 for NAV 2.
COM_RADIO_WHOLE_DEC	Decrements COM by one MHz
COM_RADIO_WHOLE_INC	Increments COM by one MHz
COM_RADIO_FRACT_DEC	Decrements COM by 25 KHz
COM_RADIO_FRACT_INC	Increments COM by 25 KHz
NAV1_RADIO_WHOLE_DEC	Decrements Nav 1 by one MHz
NAV1_RADIO_WHOLE_INC	Increments Nav 1 by one MHz
NAV1_RADIO_FRACT_DEC	Decrements Nav 1 by 25 KHz
NAV1_RADIO_FRACT_INC	Increments Nav 1 by 25 KHz
NAV2_RADIO_WHOLE_DEC	Decrements Nav 2 by one MHz
NAV2_RADIO_WHOLE_INC	Increments Nav 2 by one MHz
NAV2_RADIO_FRACT_DEC	Decrements Nav 2 by 25 KHz
NAV2_RADIO_FRACT_INC	Increments Nav 2 by 25 KHz
ADF_100_INC	Increments ADF by 100 KHz
ADF_10_INC	Increments ADF by 10 KHz
ADF_1_INC	Increments ADF by 1 KHz
XPNDR_1000_INC	Increments first digit of transponder
XPNDR_100_INC	Increments second digit of transponder
XPNDR_10_INC	Increments third digit of transponder
XPNDR_1_INC	Increments fourth digit of transponder
VOR1_OBI_DEC	Decrements the VOR 1 OBS setting
VOR1_OBI_INC	Increments the VOR 1 OBS setting
VOR2_OBI_DEC	Decrements the VOR 2 OBS setting
VOR2_OBI_INC	Increments the VOR 2 OBS setting
ADF_100_DEC	Decrements ADF by 100 KHz
ADF_10_DEC	Decrements ADF by 10 KHz
ADF_1_DEC	Decrements ADF by 1 KHz
COM_RADIO_SET	Sets COM frequency (BCD Hz)
NAV1_RADIO_SET	Sets NAV 1 frequency (BCD Hz)
NAV2_RADIO_SET	Sets NAV 2 frequency (BCD Hz)
ADF_SET	Sets ADF frequency (BCD Hz)
XPNDR_SET	Sets transponder code (BCD)
VOR1_SET	Sets OBS 1 (0 to 360)
VOR2_SET	Sets OBS 2 (0 to 360)
DME1_TOGGLE	Sets DME display to Nav 1
DME2_TOGGLE	Sets DME display to Nav 2
RADIO_VOR1_IDENT_DISABLE	Turns NAV 1 ID off
RADIO_VOR2_IDENT_DISABLE	Turns NAV 2 ID off
RADIO_DME1_IDENT_DISABLE	Turns DME 1 ID off
RADIO_DME2_IDENT_DISABLE	Turns DME 2 ID off
RADIO_ADF_IDENT_DISABLE	Turns ADF 1 ID off
RADIO_VOR1_IDENT_ENABLE	Turns NAV 1 ID on
RADIO_VOR2_IDENT_ENABLE	Turns NAV 2 ID on
RADIO_DME1_IDENT_ENABLE	Turns DME 1 ID on
RADIO_DME2_IDENT_ENABLE	Turns DME 2 ID on
RADIO_ADF_IDENT_ENABLE	Turns ADF 1 ID on
RADIO_VOR1_IDENT_TOGGLE	Toggles NAV 1 ID
RADIO_VOR2_IDENT_TOGGLE	Toggles NAV 2 ID
RADIO_DME1_IDENT_TOGGLE	Toggles DME 1 ID
RADIO_DME2_IDENT_TOGGLE	Toggles DME 2 ID
RADIO_ADF_IDENT_TOGGLE	Toggles ADF 1 ID
RADIO_VOR1_IDENT_SET	Sets NAV 1 ID (on/off)
RADIO_VOR2_IDENT_SET	Sets NAV 2 ID (on/off)
RADIO_DME1_IDENT_SET	Sets DME 1 ID (on/off)
RADIO_DME2_IDENT_SET	Sets DME 2 ID (on/off)
RADIO_ADF_IDENT_SET	Sets ADF 1 ID (on/off)
ADF_CARD_INC	Increments ADF card
ADF_CARD_DEC	Decrements ADF card
ADF_CARD_SET	Sets ADF card (0-360)
TOGGLE_DME	Toggles between NAV 1 and NAV 2
AVIONICS_MASTER_SET	Sets the avionics master switch
TOGGLE_AVIONICS_MASTER	Toggles the avionics master switch
COM_STBY_RADIO_SET	Sets COM 1 standby frequency (BCD Hz)
COM_STBY_RADIO_SWAP	Swaps COM 1 frequency with standby
COM_RADIO_FRACT_DEC_CARRY	Decrement COM 1 frequency by 25 KHz, and carry when digit wraps
COM_RADIO_FRACT_INC_CARRY	Increment COM 1 frequency by 25 KHz, and carry when digit wraps
COM2_RADIO_WHOLE_DEC	Decrement COM 2 frequency by 1 MHz, with no carry when digit wraps
COM2_RADIO_WHOLE_INC	Increment COM 2 frequency by 1 MHz, with no carry when digit wraps
COM2_RADIO_FRACT_DEC	Decrement COM 2 frequency by 25 KHz, with no carry when digit wraps
COM2_RADIO_FRACT_DEC_CARRY	Decrement COM 2 frequency by 25 KHz, and carry when digit wraps
COM2_RADIO_FRACT_INC	Increment COM 2 frequency by 25 KHz, with no carry when digit wraps
COM2_RADIO_FRACT_INC_CARRY	Increment COM 2 frequency by 25 KHz, and carry when digit wraps
COM2_RADIO_SET	Sets COM 2 frequency (BCD Hz)
COM2_STBY_RADIO_SET	Sets COM 2 standby frequency (BCD Hz)
COM2_RADIO_SWAP	Swaps COM 2 frequency with standby
NAV1_RADIO_FRACT_DEC_CARRY	Decrement NAV 1 frequency by 50 KHz, and carry when digit wraps
NAV1_RADIO_FRACT_INC_CARRY	Increment NAV 1 frequency by 50 KHz, and carry when digit wraps
NAV1_STBY_SET	Sets NAV 1 standby frequency (BCD Hz)
NAV1_RADIO_SWAP	Swaps NAV 1 frequency with standby
NAV2_RADIO_FRACT_DEC_CARRY	Decrement NAV 2 frequency by 50 KHz, and carry when digit wraps
NAV2_RADIO_FRACT_INC_CARRY	Increment NAV 2 frequency by 50 KHz, and carry when digit wraps
NAV2_STBY_SET	Sets NAV 2 standby frequency (BCD Hz)
NAV2_RADIO_SWAP	Swaps NAV 2 frequency with standby
ADF1_RADIO_TENTHS_DEC	Decrements ADF 1 by 0.1 KHz.
ADF1_RADIO_TENTHS_INC	Increments ADF 1 by 0.1 KHz.
XPNDR_1000_DEC	Decrements first digit of transponder
XPNDR_100_DEC	Decrements second digit of transponder
XPNDR_10_DEC	Decrements third digit of transponder
XPNDR_1_DEC	Decrements fourth digit of transponder
XPNDR_DEC_CARRY	Decrements fourth digit of transponder, and with carry.
XPNDR_INC_CARRY	Increments fourth digit of transponder, and with carry.
ADF_FRACT_DEC_CARRY	Decrements ADF 1 frequency by 0.1 KHz, with carry
ADF_FRACT_INC_CARRY	Increments ADF 1 frequency by 0.1 KHz, with carry
COM1_TRANSMIT_SELECT	Selects COM 1 to transmit
COM2_TRANSMIT_SELECT	Selects COM 2 to transmit
COM_RECEIVE_ALL_TOGGLE	Toggles all COM radios to receive on
COM_RECEIVE_ALL_SET	Sets whether to receive on all COM radios (1,0)
MARKER_SOUND_TOGGLE	Toggles marker beacon sound on/off
ADF_COMPLETE_SET	Sets ADF 1 frequency (BCD Hz)
ADF1_WHOLE_INC	Increments ADF 1 by 1 KHz, with carry as digits wrap.
ADF1_WHOLE_DEC	Decrements ADF 1 by 1 KHz, with carry as digits wrap.
ADF2_100_INC	Increments the ADF 2 frequency 100 digit, with wrapping
ADF2_10_INC	Increments the ADF 2 frequency 10 digit, with wrapping
ADF2_1_INC	Increments the ADF 2 frequency 1 digit, with wrapping
ADF2_RADIO_TENTHS_INC	Increments ADF 2 frequency 1/10 digit, with wrapping
ADF2_100_DEC	Decrements the ADF 2 frequency 100 digit, with wrapping
ADF2_10_DEC	Decrements the ADF 2 frequency 10 digit, with wrapping
ADF2_1_DEC	Decrements the ADF 2 frequency 1 digit, with wrapping
ADF2_RADIO_TENTHS_DEC	Decrements ADF 2 frequency 1/10 digit, with wrapping
ADF2_WHOLE_INC	Increments ADF 2 by 1 KHz, with carry as digits wrap.
ADF2_WHOLE_DEC	Decrements ADF 2 by 1 KHz, with carry as digits wrap.
ADF2_FRACT_DEC_CARRY	Decrements ADF 2 frequency by 0.1 KHz, with carry
ADF2_FRACT_INC_CARRY	Increments ADF 2 frequency by 0.1 KHz, with carry
ADF2_COMPLETE_SET	Sets ADF 1 frequency (BCD Hz)
RADIO_ADF2_IDENT_DISABLE	Turns ADF 2 ID off
RADIO_ADF2_IDENT_ENABLE	Turns ADF 2 ID on
RADIO_ADF2_IDENT_TOGGLE	Toggles ADF 2 ID
RADIO_ADF2_IDENT_SET	Sets ADF 2 ID on/off (1,0)
FREQUENCY_SWAP	Swaps frequency with standby on whichever NAV or COM radio is selected.
TOGGLE_GPS_DRIVES_NAV1	Toggles between GPS and NAV 1 driving NAV 1 OBS display (and AP)
GPS_POWER_BUTTON	Toggles power button
GPS_NEAREST_BUTTON	Selects Nearest Airport Page
GPS_OBS_BUTTON	Toggles automatic sequencing of waypoints
GPS_MSG_BUTTON	Toggles the Message Page
GPS_MSG_BUTTON_DOWN	Triggers the pressing of the message button.
GPS_MSG_BUTTON_UP	Triggers the release of the message button
GPS_FLIGHTPLAN_BUTTON	Displays the programmed flightplan.
GPS_TERRAIN_BUTTON	Displays terrain information on default display
GPS_PROCEDURE_BUTTON	Displays the approach procedure page.
GPS_ZOOMIN_BUTTON	Zooms in default display
GPS_ZOOMOUT_BUTTON	Zooms out default display
GPS_DIRECTTO_BUTTON	Brings up the "Direct To" page
GPS_MENU_BUTTON	Brings up page to select active legs in a flightplan.
GPS_CLEAR_BUTTON	Clears entered data on a page
GPS_CLEAR_ALL_BUTTON	Clears all data immediately
GPS_CLEAR_BUTTON_DOWN	Triggers the pressing of the Clear button
GPS_CLEAR_BUTTON_UP	Triggers the release of the Clear button.
GPS_ENTER_BUTTON	Approves entered data.
GPS_CURSOR_BUTTON	Selects GPS cursor
GPS_GROUP_KNOB_INC	Increments cursor
GPS_GROUP_KNOB_DEC	Decrements cursor
GPS_PAGE_KNOB_INC	Increments through pages
GPS_PAGE_KNOB_DEC	Decrements through pages
DME_SELECT	Selects one of the two DME systems (1,2).
RADIO_SELECTED_DME_IDENT_ENABLE	Turns on the identification sound for the selected DME.
RADIO_SELECTED_DME_IDENT_DISABLE	Turns off the identification sound for the selected DME.
RADIO_SELECTED_DME_IDENT_SET	Sets the DME identification sound to the given filename.
RADIO_SELECTED_DME_IDENT_TOGGLE	Turns on or off the identification sound for the selected DME.



EGT	Selects EGT bug for +/-
EGT_INC	Increments EGT bugs
EGT_DEC	Decrements EGT bugs
EGT_SET	Sets EGT bugs (0 to 32767)
BAROMETRIC	Syncs altimeter setting to sea level pressure, or 29.92 if above 18000 feet
GYRO_DRIFT_INC	Increments heading indicator
GYRO_DRIFT_DEC	Decrements heading indicator
KOHLSMAN_INC	Increments altimeter setting
KOHLSMAN_DEC	Decrements altimeter setting
KOHLSMAN_SET	Sets altimeter setting (Millibars * 16)
TRUE_AIRSPEED_CAL_INC	Increments airspeed indicators true airspeed reference card
TRUE_AIRSPEED_CAL_DEC	Decrements airspeed indicators true airspeed reference card
TRUE_AIRSPEED_CAL_SET	Sets airspeed indicators true airspeed reference card (degrees, where 0 is standard sea level conditions)
EGT1_INC	Increments EGT bug 1
EGT1_DEC	Decrements EGT bug 1
EGT1_SET	Sets EGT bug 1 (0 to 32767)
EGT2_INC	Increments EGT bug 2
EGT2_DEC	Decrements EGT bug 2
EGT2_SET	Sets EGT bug 2 (0 to 32767)
EGT3_INC	Increments EGT bug 3
EGT3_DEC	Decrements EGT bug 3
EGT3_SET	Sets EGT bug 3 (0 to 32767)
EGT4_INC	Increments EGT bug 4
EGT4_DEC	Decrements EGT bug 4
EGT4_SET	Sets EGT bug 4 (0 to 32767)
ATTITUDE_BARS_POSITION_UP	Increments attitude indicator pitch reference bars
ATTITUDE_BARS_POSITION_DOWN	Decrements attitude indicator pitch reference bars
ATTITUDE_CAGE_BUTTON	Cages attitude indicator at 0 pitch and bank
RESET_G_FORCE_INDICATOR	Resets max/min indicated G force to 1.0.
RESET_MAX_RPM_INDICATOR	Reset max indicated engine rpm to 0.
HEADING_GYRO_SET	Sets heading indicator to 0 drift error.
GYRO_DRIFT_SET	Sets heading indicator drift angle (degrees).


STROBES_TOGGLE	Toggle strobe lights
ALL_LIGHTS_TOGGLE	Toggle all lights
PANEL_LIGHTS_TOGGLE	Toggle panel lights
LANDING_LIGHTS_TOGGLE	Toggle landing lights
LANDING_LIGHT_UP	Rotate landing light up
LANDING_LIGHT_DOWN	Rotate landing light down
LANDING_LIGHT_LEFT	Rotate landing light left
LANDING_LIGHT_RIGHT	Rotate landing light right
LANDING_LIGHT_HOME	Return landing light to default position
STROBES_ON	Turn strobe lights on
STROBES_OFF	Turn strobe light off
STROBES_SET	Set strobe lights on/off (1,0)
PANEL_LIGHTS_ON	Turn panel lights on
PANEL_LIGHTS_OFF	Turn panel lights off
PANEL_LIGHTS_SET	Set panel lights on/off (1,0)
LANDING_LIGHTS_ON	Turn landing lights on
LANDING_LIGHTS_OFF	Turn landing lights off
LANDING_LIGHTS_SET	Set landing lights on/off (1,0)
TOGGLE_BEACON_LIGHTS	Toggle beacon lights
TOGGLE_TAXI_LIGHTS	Toggle taxi lights
TOGGLE_LOGO_LIGHTS	Toggle logo lights
TOGGLE_RECOGNITION_LIGHTS	Toggle recognition lights
TOGGLE_WING_LIGHTS	Toggle wing lights
TOGGLE_NAV_LIGHTS	Toggle navigation lights
TOGGLE_CABIN_LIGHTS	Toggle cockpit/cabin lights


TOGGLE_VACUUM_FAILURE	Toggle vacuum system failure
TOGGLE_ELECTRICAL_FAILURE	Toggle electrical system failure
TOGGLE_PITOT_BLOCKAGE	Toggles blocked pitot tube
TOGGLE_STATIC_PORT_BLOCKAGE	Toggles blocked static port
TOGGLE_HYDRAULIC_FAILURE	Toggles hydraulic system failure
TOGGLE_TOTAL_BRAKE_FAILURE	Toggles brake failure (both)
TOGGLE_LEFT_BRAKE_FAILURE	Toggles left brake failure
TOGGLE_RIGHT_BRAKE_FAILURE	Toggles right brake failure
TOGGLE_ENGINE1_FAILURE	Toggle engine 1 failure
TOGGLE_ENGINE2_FAILURE	Toggle engine 2 failure
TOGGLE_ENGINE3_FAILURE	Toggle engine 3 failure
TOGGLE_ENGINE4_FAILURE	Toggle engine 4 failure


SMOKE_TOGGLE	Toggle smoke system switch
GEAR_TOGGLE	Toggle gear handle
BRAKES	Increment brake pressure
GEAR_SET	Sets gear handle position up/down (0,1)
BRAKES_LEFT	Increments left brake pressure
BRAKES_RIGHT	Increments right brake pressure
PARKING_BRAKES	Toggles parking brake on/off
GEAR_PUMP	Increments emergency gear extension
PITOT_HEAT_TOGGLE	Toggles pitot heat switch
SMOKE_ON	Turns smoke system on
SMOKE_OFF	Turns smoke system off
SMOKE_SET	Sets smoke system on/off (1,0)
PITOT_HEAT_ON	Turns pitot heat switch on
PITOT_HEAT_OFF	Turns pitot heat switch off
PITOT_HEAT_SET	Sets pitot heat switch on/off (1,0)
GEAR_UP	Sets gear handle in UP position
GEAR_DOWN	Sets gear handle in DOWN position
TOGGLE_MASTER_BATTERY	Toggles main battery switch
TOGGLE_MASTER_ALTERNATOR	Toggles main alternator/generator switch
TOGGLE_ELECTRIC_VACUUM_PUMP	Toggles backup electric vacuum pump
TOGGLE_ALTERNATE_STATIC	Toggles alternate static pressure port
DECREASE_DECISION_HEIGHT	Decrements decision height reference
INCREASE_DECISION_HEIGHT	Increments decision height reference
TOGGLE_STRUCTURAL_DEICE	Toggles structural deice switch
TOGGLE_PROPELLER_DEICE	Toggles propeller deice switch
TOGGLE_ALTERNATOR1	Toggles alternator/generator 1 switch
TOGGLE_ALTERNATOR2	Toggles alternator/generator 2 switch
TOGGLE_ALTERNATOR3	Toggles alternator/generator 3 switch
TOGGLE_ALTERNATOR4	Toggles alternator/generator 4 switch
TOGGLE_MASTER_BATTERY_ALTERNATOR	Toggles master battery and alternator switch
AXIS_LEFT_BRAKE_SET	Sets left brake position from axis controller (e.g. joystick). -16383 (0 brakes) to +16383 (max brakes)
AXIS_RIGHT_BRAKE_SET	Sets right brake position from axis controller (e.g. joystick). -16383 (0 brakes) to +16383 (max brakes)
TOGGLE_AIRCRAFT_EXIT	Toggles primary door open/close. Follow by KEY_SELECT_2, etc for subsequent doors.
TOGGLE_WING_FOLD	Toggles wing folding
SET_WING_FOLD	Sets the wings into the folded position suitable for storage, typically on a carrier. Takes a value: 1 - fold wings, 0 - unfold wings
TOGGLE_TAIL_HOOK_HANDLE	Toggles tail hook
SET_TAIL_HOOK_HANDLE	Sets the tail hook handle. Takes a value: 1 - set tail hook, 0 - retract tail hook
TOGGLE_WATER_RUDDER	Toggles water rudders
TOGGLE_PUSHBACK	Toggles pushback.
KEY_TUG_HEADING	Triggers tug and sets the desired heading. The units are a 32 bit integer (0 to 4294967295) which represent 0 to 360 degrees. To set a 45 degree angle, for example, set the value to 4294967295 / 8.
KEY_TUG_SPEED	Triggers tug, and sets desired speed, in feet per second. The speed can be both positive (forward movement) and negative (backward movement).
TUG_DISABLE	Disables tug
TOGGLE_MASTER_IGNITION_SWITCH	Toggles master ignition switch
TOGGLE_TAILWHEEL_LOCK	Toggles tail wheel lock
ADD_FUEL_QUANTITY	Adds fuel to the aircraft, 25% of capacity by default. 0 to 65535 (max fuel) can be passed.
TOW_PLANE_RELEASE	Release a towed aircraft, usually a glider.
TOW_PLANE_REQUEST	Request a tow plane. The user aircraft must be tow-able, stationary, on the ground and not already attached for this to succeed.
RELEASE_DROPPABLE_OBJECTS	Release one droppable object. Multiple key events will release multiple objects.
RETRACT_FLOAT_SWITCH_DEC	If the plane has retractable floats, moves the retract position from Extend to Neutral, or Neutral to Retract.
RETRACT_FLOAT_SWITCH_INC	If the plane has retractable floats, moves the retract position from Retract to Neutral, or Neutral to Extend.
TOGGLE_WATER_BALLAST_VALVE	Turn the water ballast valve on or off.
TOGGLE_VARIOMETER_SWITCH	Turn the variometer on or off.
TOGGLE_TURN_INDICATOR_SWITCH	Turn the turn indicator on or off.
APU_STARTER	Start up the auxiliary power unit (APU).
APU_OFF_SWITCH	Turn the APU off.
APU_GENERATOR_SWITCH_TOGGLE	Turn the auxiliary generator on or off.
APU_GENERATOR_SWITCH_SET	Set the auxiliary generator switch (0,1).
EXTINGUISH_ENGINE_FIRE	Takes a two digit argument.  The first digit represents the fire extinguisher index, and the second represents the engine index.  For example,  11 would represent using bottle 1 on engine 1.  21 would represent using bottle 2 on engine 1.  Typical entries for a twin engine aircraft would be 11 and 22.
HYDRAULIC_SWITCH_TOGGLE	Turn the hydraulic switch on or off.
BLEED_AIR_SOURCE_CONTROL_INC	Increases the bleed air source control.
BLEED_AIR_SOURCE_CONTROL_DEC	Decreases the bleed air source control.
BLEED_AIR_SOURCE_CONTROL_SET	Set to one of: 0: auto 1: off 2: apu 3: engines
TURBINE_IGNITION_SWITCH_TOGGLE	Turn the turbine ignition switch on or off.
CABIN_NO_SMOKING_ALERT_SWITCH_TOGGLE	Turn the "No smoking" alert on or off.
CABIN_SEATBELTS_ALERT_SWITCH_TOGGLE	Turn the "Fasten seatbelts" alert on or off.
ANTISKID_BRAKES_TOGGLE	Turn the anti-skid braking system on or off.
GPWS_SWITCH_TOGGLE	Turn the g round proximity warning system (GPWS) on or off.
MANUAL_FUEL_PRESSURE_PUMP	Activate the manual fuel pressure pump.

STEERING_INC	Increments the nose wheel steering position by 5 percent.
STEERING_DEC	Decrements the nose wheel steering position by 5 percent.
STEERING_SET	Sets the value of the nose wheel steering position. Zero is straight ahead (-16383, far left +16383, far right).

KEY_PRESSURIZATION_PRESSURE_ALT_INC	Increases the altitude that the cabin is pressurized to.
KEY_PRESSURIZATION_PRESSURE_ALT_DEC	Decreases the altitude that the cabin is pressurized to.
PRESSURIZATION_CLIMB_RATE_INC	Sets the rate at which cabin pressurization is increased.
PRESSURIZATION_CLIMB_RATE_DEC	Sets the rate at which cabin pressurization is decreased.
PRESSURIZATION_PRESSURE_DUMP_SWTICH	Sets the cabin pressure to the outside air pressure.

TAKEOFF_ASSIST_ARM_TOGGLE	Deploy or remove the assist arm. Refer to the document Notes on Aircraft Systems.
TAKEOFF_ASSIST_ARM_SET	Value: TRUE request set FALSE request unset
TAKEOFF_ASSIST_FIRE	If everything is set up correctly. Launch from the catapult.
TOGGLE_LAUNCH_BAR_SWITCH	Toggle the request for the launch bar to be installed or removed.
SET_LAUNCH_BAR_SWITCH	Value: TRUE request set FALSE request unset

PAUSE_TOGGLE	Toggles pause on/off
PAUSE_ON	Turns pause on
PAUSE_OFF	Turns pause off
PAUSE_SET	Sets pause on/off (1,0)
DEMO_STOP	Stops demo system playback
SELECT_1	Sets "selected" index (for other events) to 1
SELECT_2	Sets "selected" index (for other events) to 2
SELECT_3	Sets "selected" index (for other events) to 3
SELECT_4	Sets "selected" index (for other events) to 4
MINUS	Used in conjunction with "selected" parameters to decrease their value (e.g., radio frequency)
PLUS	Used in conjunction with "selected" parameters to increase their value (e.g., radio frequency)
ZOOM_1X	Sets zoom level to 1
SOUND_TOGGLE	Toggles sound on/off
SIM_RATE	Selects simulation rate (use KEY_MINUS, KEY_PLUS to change)
JOYSTICK_CALIBRATE	Toggles joystick on/off
SITUATION_SAVE	Saves flight situation
SITUATION_RESET	Resets flight situation
SOUND_SET	Sets sound on/off (1,0)
EXIT	Quit ESP with a message
ABORT	Quit ESP without a message
READOUTS_SLEW	Cycle through information readouts while in slew
READOUTS_FLIGHT	Cycle through information readouts
MINUS_SHIFT	Used with other events
PLUS_SHIFT	Used with other events
SIM_RATE_INCR	Increase sim rate
SIM_RATE_DECR	Decrease sim rate
KNEEBOARD_VIEW	Toggles kneeboard
PANEL_1	Toggles panel 1
PANEL_2	Toggles panel 2
PANEL_3	Toggles panel 3
PANEL_4	Toggles panel 4
PANEL_5	Toggles panel 5
PANEL_6	Toggles panel 6
PANEL_7	Toggles panel 7
PANEL_8	Toggles panel 8
PANEL_9	Toggles panel 9
SOUND_ON	Turns sound on
SOUND_OFF	Turns sound off
INVOKE_HELP	Brings up Help system
TOGGLE_AIRCRAFT_LABELS	Toggles aircraft labels
FLIGHT_MAP	Brings up flight map
RELOAD_PANELS	Reload panel data
PANEL_ID_TOGGLE	Toggles indexed panel (1 to 9)
PANEL_ID_OPEN	Opens indexed panel (1 to 9)
PANEL_ID_CLOSE	Closes indexed panel (1 to 9)
RELOAD_USER_AIRCRAFT	Reloads the user aircraft data (from cache if same type loaded as an AI, otherwise from disk)
SIM_RESET	Resets aircraft state
VIRTUAL_COPILOT_TOGGLE	Turns Flying Tips on/off
VIRTUAL_COPILOT_SET	Sets Flying Tips on/off (1,0)
VIRTUAL_COPILOT_ACTION	Triggers action noted in Flying Tips
REFRESH_SCENERY	Reloads scenery
CLOCK_HOURS_DEC	Decrements time by hours
CLOCK_HOURS_INC	Increments time by hours
CLOCK_MINUTES_DEC	Decrements time by minutes
CLOCK_MINUTES_INC	Increments time by minutes
CLOCK_SECONDS_ZERO	Zeros seconds
CLOCK_HOURS_SET	Sets hour of day
CLOCK_MINUTES_SET	Sets minutes of the hour
ZULU_HOURS_SET	Sets hours, zulu time
ZULU_MINUTES_SET	Sets minutes, in zulu time
ZULU_DAY_SET	Sets day, in zulu time
ZULU_YEAR_SET	Sets year, in zulu time
GAUGE_KEYSTROKE	Enables a keystroke to be sent to a gauge that is in focus. The keystrokes can only be in the range 0 to 9, A to Z, and the four keys: plus, minus, comma and period. This is typically used to allow some keyboard entry to a complex device such as a GPS to enter such things as ICAO codes using the keyboard, rather than turning dials.
SIMUI_WINDOW_HIDESHOW	Display the ATC window.
VIEW_WINDOW_TITLES_TOGGLE	Turn window titles on or off.
AXIS_PAN_PITCH	Sets the pitch of the axis. Requires an angle.
AXIS_PAN_HEADING	Sets the heading of the axis. Requires an angle.
AXIS_PAN_TILT	Sets the tilt of the axis. Requires an angle.
VIEW_AXIS_INDICATOR_CYCLE	Step through the view axes.
VIEW_MAP_ORIENTATION_CYCLE	Step through the map orientations.
TOGGLE_JETWAY	Requests a jetway, which will only be answered if the aircraft is at a parking spot.
VIDEO_RECORD_TOGGLE	Turn on or off the video recording feature. This records uncompressed AVI format files to: My Documents\My Videos\
TOGGLE_AIRPORT_NAME_DISPLAY	Turn on or off the airport name.
CAPTURE_SCREENSHOT	Capture the current view as a screenshot. Which will be saved to a bmp file in: My Documents\My Pictures\
MOUSE_LOOK_TOGGLE	Switch Mouse Look mode on or off. Mouse Look mode enables a user to control their view using the mouse, and holding down the space bar.
YAXIS_INVERT_TOGGLE	Switch inversion of Y axis controls on or off.
AUTORUDDER_TOGGLE	Turn the automatic rudder control feature on or off.
